###########
#P-B---B-E#
#-#B#-#B#-#
#BBB---BBB#
#-#-#B#-#-#
#-B-BEB-B-#
#-#-#B#-#-#
#BBB---BBB#
#-#B#-#B#-#
#E-B---B-E#
###########