###########
#E--BBB--E#
#--BBBBB--#
#-BBBBBBB-#
#BBB---BBB#
#BBB-P-BBB#
#BBB---BBB#
#-BBBBBBB-#
#--BBBBB--#
#E--BBB--E#
###########