###########
#P-B-BB-E-#
#-#B#-#-#-#
#---B-----#
#B#B#-#-#-#
#E--BBBBBB#
#-#-#B#-#-#
#----B--E-#
#B#B#B#-#-#
#BBE-B----#
###########