###########
###-----###
#--E----B-#
#B----B-B-#
#---##-#-##
#--B--P--B#
#E-B----BB#
#--BB##BBB#
#------E--#
###B----###
###########